1111111111111111111111111111111111
1000000000000000000000000000000001
1000000000000000000000000000000001
1000100111101111010111100010100001
1001000100001001000100000100010001
10100001111011110101C1001000001001
10010000001010010101PC010000010001
100010011110100101010E100000000001
100000P000000N00000000000000000001
1000000000000000000000000000000001
1111111111111111111111111111111111