1111111111111111111111111111111111
1000000000000000000000000000000001
1000000000000000000000000000000001
1000100111101111010111100010100001
1001000100001001000100000100010001
1010000111101111010111001000001001
100100000010100101010C010000010001
100010011110100101010E100000000001
10000000P00000000000000N0000000001
1000000000000000000000000000000001
1111111111111111111111111111111111