1111111111111111111111111111111111
1000N000000CN000C000000C0000N00001
1000100111101111010111100010100001
1001000100001001000100000100010001
1010CC0111101111010111001000001001
10010000001010010101PC010000010001
100010011110100101010E100000100001
100C000N000C00000N00000N0CC0000001
1111111111111111111111111111111111